#################
#................#
.................
#................#
####...##.##.....
#...#..#.##.#....#
######.##.##.##..
#...#.#......#.#.#
....##.......##..
#................#
...............##
#..............#.#
.............##..
#............#...#
......###.###....
#.....#..##......#
....#.###........
#...##....#......#
..##.............
#.#..#....#......#
#################