#############
#............#
.........####
#........#...#
...#.#..#####
#..####.##...#
#..#.#..#....
##...........#
#..........#.
#..........###
.##.##..##.#.
##.##.#.#.#..#
.##.##..##..#
#...........##
............#
#............#
...........##
#..........#.#
.....#...#.#.
#....##..##.##
...#...#....#
#..########..#
.#...#...#...
#####..##....#
.#.#...#.....
#............#
#............
##...........#
.#.#.#.#.....
#.#######....#
...#.#.#.#...
#.#......##..#
..........#..
#.#......#.#.#
#############
