##################################
#.................................#
..........................#.......
#.........................##......#
......##...........#.....##.......
#.....#.#..........##....##.......#
...#..##...#...##..#..#..#...#....
#..##......##..#.#....##.....##...#
##.#.......#..........#......#..##
#.#............#.#..............#.#
.#...............#..............##
##.............#..#...............#
.##############...................
#.................#...............#
##################################
